11
20
********************
*** ******         *
*** ****** ******* *
P               ** *
*** *** ******* ** *
*** *** ***   * ** *
*** *** *** * **** *
*     *     *      T
* ******** *********
*               ****
********************
